                 SO ./texture/so.xpm
   F                 5, 78, 12
   NO ./texture/no.xpm

 EA ./texture/ea.xpm
        
   C           44,          30,  45 



WE                         texture/we.xpm



11111111111111111111111111111111111111111111111111111
11111111111111111000000000000000000001
10000000000000111111000000111111111111
111111111111111111111111111111111111111
111111111111111111111111
11111111110000000000111
1111111111100000000111111                                         1111111111
11111111111100W00010000011                                      1110001111
1111111111110110000000011                                      111111111
11111111111110000000000011
100100000111111111111111111111111
11111111111111111111111111101
111111111111110111111111111111
111111111111111111111111111
